####################
#B        #   #     
##### ### # ### # ##
#     #   #     #   
# ##### ##### ##### 
# #   #     # #     
# # ####### # # ####
# #         # # #A  
# # ##### ##### ### 
# # #   #       #   
# ### # ### ##### ##
# #   # #   #   #   
# # ### # ### # ### 
#     # # #   # #   
####### # # ### # ##
#       # # #   # # 
# ######### # ### # 
#   #   #   #   # # 
# # # # # ##### # # 
# #   #       #     
