##################################################
#   #                 #     #     #               
### # ########### ### # ### # ### # # ########### 
#   # #   #       #   #   # # #   # #   #       # 
# # # ### # ####### ####### # # ### ### # ##### ##
# # #     # #       #     # # #       #   #   #   
# ####### # ### ##### ### # # ######### ##### ### 
# #     # #   #       #     #   #     #       #   
# # # ### ### ############### ### ### # ##### # ##
# # #     # #     #     #     #   #   # #   # #   
# # ####### ##### # ### # ##### ### ##### # ##### 
#   #   #       #     # #   #   # # #   # #   #   
# ### # ### ### ####### # ### ### # # # # ### # # 
#     #   # #     #   #   #   #   #   #   #     # 
######### ### # ### # ##### ### ### ############# 
#       #     # #   #     #   #     #     #     # 
##### # ####### # # ##### ### # ##### ### # ### ##
#     # #     # # # #   #     # #   # #B    # #   
# ##### # ##### # ### # ####### # # # ####### ### 
# #   #   #   # #     # #     #   # #     #       
# # # ##### # # ####### ##### ### ####### ##### ##
#   #     # #   #   # #     #     #     #     # # 
# ####### # ##### # # ##### # ##### ### ##### # # 
# #   # # #   #   #     #   #     # #   # #   #   
# # # # # ### ### ##### # ######### # # # # ##### 
#   # # #     #   # #   #   #       # #   #    A# 
##### # ####### ### # ##### # ####### ########### 
# #   #       #   # # #   # # #   # #           # 
# # ####### # ### # # ### # # # # # ######### ### 
#           #     #       #     #           #     
