#             #     #
# # ####### ### # ###
# # #     # #   #   #
# # # ### # # ##### #
# #     # # # #     #
# ####### # # # #####
# # #     # # #   # #
# # # ####### ### # #
# # #     #   # #A# #
# # ##### # ### ### #
# #     # # # #     #
# # ##### # # # ### #
#   #     # #     # #
### # ### # ##### # #
#   #   # #   #   # #
# ##### ##### ##### #
# #   #     #     # #
# ### ### ####### # #
#       #      B#   #
####### ### ####### #
#         #         #
