#########################################
B   #                 #   #             #
### ### # # ##### ### # # ######### # ###
#     # # #   #   #   # # #     #   #   #
### ### ### # # ### # ### # ### ##### # #
#         # # # #   # #     # #   #   # #
# ########### ### ####### ### ####### ###
# # #   #   # #   #   #       #         #
# # # # # ##### ### # # ### ##### # # # #
# # # # #     # #   #     #       # # # #
# # # ### ##### # # ### ########### #####
# # #   #   # #   #   #   #         # # #
# # ### ### # ##### # # ######### ### # #
#       #   #     # # # #     #   #   # #
##### ##### ### # ##### ### # ### # # # #
# #     #   #   #   #       #   #   #   #
# # # # # ### ####### ##### ### ### ### #
# # # #   #     #   #     # #     # # # #
# # # # ### ### # ####### ####### ### # #
#   # #       # #           #     #     #
#######################################A#