####################################################################################################
     #         #           #   #         #       #             #                       #     #     #
 ### ### ##### # ######### # # # ##### # # ##### # ##### # ##### ####### ##### ##### ### # # ##### #
 # #   # #     #         # # #   #   # # #     #   # #   # #     # #     #   # #   # #   # # #   # #
 # ### ### # ### ######### # ##### # # ####### ##### # ### # ##### # ##### # # # # ### ### # # # # #
 #         # #   #       # # #   # # #     #   #     #   # #   #   #   #   # # # #     # # #   #   #
 # ########### ### ##### # # # ### # ### ### ##### # ### # ### # ##### # ### # # ####### # ####### #
 # #         #   # # #     # #   # #   #   #   #   #   # # #   # #   # #   #   #         #   # #   #
 ### ####### # ### # # ##### ### # ### ### ### # ##### # ### ### # # # ############### ##### # # ###
 #   #     #   #   #     #   #   # # #   #   # # #   # # #   #   # # #       #   #     #   # #   # #
 # ### ### ##### ### ##### ### ### # # ##### # # # # # # # ### # # # ####### # # # ##### # # # ### #
     #   #     # # # # #   #         #     # # #   # # #       # # #         # #   # #   # # #     #
#### ### ### # # # # # # ### ########### # # # ##### # ########### ########### ##### # ### # #######
   # #   #   # # #     #   #     #       # # #       #     #       #     #       #   # #     #     #
 # # ##### ### # ######### ##### # ####### # ##### ######### ##### # ### # ##### # # # ####### ### #
 # #       #   #           #   # # #     # # #     #       #     # # #   # #   #   # #     #   # # #
 # ##### ####### ########### # ### # ### # # # ##### ##### # ### # # # ### # # ##### ##### # ### # #
 # #     #     #   #     #   #     #   #   #   #     #   # # # # # # #     # # #     #   #       # #
 # ####### ### ### # ### # ########### ######### ##### # # # # # ### ####### # ####### # ####### # #
 #         # #   # # # #   #       #   #       # #   # #   #   #     #     # #       # #     #   # #
 ########### ### # # # ##### ##### # ### ####### # ### ############# # ### # ####### # ##### # ### #
 #       #     # #   #     #     #       #       #   # #           # # #   # #     #   #     #   # #
 ##### # # ### # ##### # ##### ########### ####### # # # ### ##### # # ### # # # ####### ######### #
     # #   #   #   #   #       #         #   #   # #   #   # #   # # #   # # # # #     #   #       #
#### # ########### # ########### ####### ### ### # ######### ### # ##### # # # # # ### ### ### ### #
     #           # # #   #       #   # #   #   #   #       # #   #     # #   # #   # #   #   # #   #
 ##### ####### # # # ### # ####### # # ### ### # ### ##### # # ####### # ##### ##### # ##### # #####
 #     #     # # # #     # #       #     #     #   #   #   # #       #   #   # #     # #     # #   #
 ### ####### # ### ####### # ### # ############### ### # ### # ##### ##### ### # ### # # ##### # # #
   #   #     #             # # # # #           # #   # # #   # #   #       #   # #   #   #   # # # #
 # ### # ### ####### ####### # # ### ####### # # ### # # ### # # # # ##### # ##### # ##### # # # # #
 #   #   # # #     # #   #     #   # #   # # #     #   #     # # #   #   # #   #   # #     # # # # #
 ### ##### # # ### ### # # ####### # # # # # ################### ##### ### ### # ##### ### # # # # #
 #   #       # # # #   # # #     #     #   # #                   # #         # #         # # #   # #
## # ####### # # # # ### # # ### ######### # # ######### # ####### # ######### ### ####### # ##### #
   # #     # #   #   #   # # #   #   #   # #       #   # # # #       # #     #   # #   #   #     # #
 ### # ### ### ####### ### # # ### # # # ######### # # ### # # ####### # ### ### # # ### ####### # #
   # #   #     #     # #   # #     #   # #   #     # #     #     #     # # #   # # #   # #   #   # #
 # # ### ####### ### # ##### ########### # # ##### # ########### # ### # # # ### # # # # # # # ### #
 # #   # #   #   # # # #     #         #   #     # #           # # #   # # #     # # # # # #   #   #
 # ##### # # # ### # # # ##### ### ############# # ########### # ### # # # ####### # # # ### ### ###
 #       # # # #     # #     #   #           #   # #         # #     # # #   #     # # #   #   #   #
 ########### # # ##### ##### ########### # ### ### # ######### # ##### # # ### ####### ### ### # # #
     #       # #       #   # #   #       # #   # #   #     #   # #   # # #       #       #   # # # #
#### ### ### # ####### # # # # # # ##### ### ### ### # ### # # ### # ### ####### # ######### # ### #
   #   #   # #     # #   # # # # #   # # #   #     # #   #   # #   # #   #   # # #         # #     #
 ##### # # ####### # ##### # # # ### # # # ### ##### ### # ##### ### # ### # # # ######### # #######
     # # #   #     #       #   #     # # #   #       # # # #     # #   #   # #         #   # #     #
#### # ##### # ### ################### # ### # ####### # ### ##### ##### ### ######### # # # # ### #
     #     # #   # #                   # #   #   #     #     #     #   # # #   #   #   # # #   #   #
 # ####### # ### # # ############# ### # # ##### ### # ####### # # # # # # ### # # # ### # ##### # #
 # #     # #   # # # #         #   # # # #     #     #   #   # # #   #   #   # # #   #   # #     # #
 ### ### # ### # # # # ##### # # ### # # ##### ######### # ### # ######### ### # ####### ### ##### #
   #   # # #   # # # # #   # # #   #   # #     #     #   # #   # #         #   #   #     #   #     #
 # ### # # # # # ### ### # # # ### ##### # ##### ### # ### # ### # # ### ### ##### # ##### ### #####
 #   # # # # # #   #   # # # #   #       #   #   #   #   #   #   # #   # #   #   # #     # #       #
 ### # # # # # ### ### # # ### # ####### ### ##### ##### ##### ####### # # ### # # ##### # # ##### #
   #   # #   #   #     # #     #   #   #   #     #     #       #       # # #   # # #     # # #   # #
######## ####### ####### ########### # ######### ##### ######### ####### # # ##### # ##### # # # # #
         #   # # #       #     #   # # #         #   #         #       # # # #       #     # # # # #
 ####### # # # # # # ### # ### # # # # # ######### # # ### ##### ##### ### # # ####### # ##### # ###
 #     #   #   # # #   # #   #   #   #   #   # #   #   #   #   #     #     # #   #     # #   # #   #
 # # # ####### # ### # # ### ############# # # # # ### ##### # ##### ####### ### # ####### # # ### #
 # # # #     # #   # # # #   #             # #   # #   #     #     #       #     #         #   # # #
 # # ### # ### ### # # ### # # ############# # ### ### # ######### ####### # ############# ##### # #
 # # #   #     #   # #   # # #   #         # #   #   # # #     #     #     # #       #   #       # #
 ### # ######### ####### # # ### # ####### # ### ### ### # # ### ##### ##### # # ##### # ##### ### #
   #   #   #   #     #   # # # # #   #   # # #     #     # #   #       #       # #     #   #   #   #
## # ### # ### ##### # ### # # # ### # # # # ####### ######### ########### ####### ####### # ### # #
   #     #     #   # #   # #   #   #   # # #   #   #         #           # #     #   #     #   # # #
 ############# # ### # # # ### ### ##### # ### # # ######### # ######### ### ### ### # ####### # # #
         #       #   # # #   #   #   #   #   # # #   # #     #   #     #     # # #   #       # # # #
 ##### # ####### # ##### ### ### ### ##### # # # ### # # ####### # ### ####### # # ######### # # ###
 #   # # #   #   #   #     #   #   #       # # # # # #     #   # #   #  A#     #   #   #     # #   #
 # # ### # # # ##### # ####### ############# # # # # ##### # # # ### ##### ### ##### ### ######### #
 # #     # # # #   # #     #   #       #   # #   # #   #   # #     # #     #       #   # #     #   #
 # ####### # # ### # ##### # ### ### # # # # ##### ### # ### ####### # ####### ##### # # ### # # # #
 #         # #     #       #     # # #   # # #       # #     #       #       # #   # #   #   # # # #
 ########### ############# ####### # ####### # ### ### ####### ####### ##### ### # # ##### ### # # #
   #       #         #     #       #   #     #   #   #         #     #     # #   #   #     #   # # #
## # ##### ####### ### ####### ### ### # ####### ### ########### ####### ### # ####### # ### ### # #
   #   #         #   # #     # # #   # # #     # # #   #         #       #   #   #     # #   #   # #
 ####### ####### ### # # ### # # # ### # ### # # # # ### ##### # # ####### ##### ####### # ### ### #
 #       # #       # # # # #   # # #   #     # # # #     #     # # #     #       #     # #   # #   #
 # # ##### # ####### # # # ##### # # ######### # # ####### ### ### # ### ######### ### # ### # #####
 # #     #   # #     #   #       # #       #   # #     #   #   #   # #     #   #   #   # #   # #   #
 ### ### # ### # ######### ### # # ##### # # ### # # ### ####### ### # ### # ### # # ### # ### # # #
   # #   #   # # #     #   #   # # #   # # # #   # # #   #       #   # #   #     # #     # # #   # #
## # # ##### # # # # # ##### ### # # ### # # # ##### # ### ####### ### ### ### ### ####### # # ### #
   # # #   # # #   # # #   #   # # # #   # # #     # #   # #         #   #   #   #   #   # # # #   #
 ##### ### # # ##### # # # ### # # # # ### # ##### # ### # ############# ### ####### # # # # # # # #
   #   #   # #     # #   #     # # # # #   # #     #   # #   #       #   #           # # # #   # # #
## # ### ### ##### # # ########### # # # ### ##### # # # ### # ##### # ############### ### ##### ###
 # # #     #       # # #         #   # #   # #   #   # #   #   #   # #   #   #             #   #   #
 # # ##### ####### # # # ####### ### # ### # # # ##### # # ##### # # # # # # ### ########### # ### #
 # # #         #   # # # #   #     # # #   #   #     # # #   #   # # # #   #   #   #         #   # #
 # # # ######### ### ### # # # ##### # ############# # # ### # ##### ######### ### ### ######### # #
 # # # #       # # #   #   # #     # # #           # # #   #   #   #         # # # #   #   #   # # #
 # # # # ##### # # ### ##### ##### # # # ####### ### # ### ##### # ######### # # # # ### ### # # # #
     #       #       #           #   #        B#     #   #       #             #     #       #     #
