##################################################
     #             #   #         #   #       #   #
## # ##### ##### # # # ### ##### # # # # ### ### #
   #     #   #   #   #     #   # # # # # # #     #
 ####### ### # ############# ### # # # # # ##### #
     # # #B  # #       #       # # #   # #       #
#### # # ##### ##### ### ##### # ####### # #######
     #       # #     #   #   #   #   #   #   #   #
 ########### # # ### # ##### ##### # # ##### # ###
         # #   #   # # #           #   # #   #   #
 ####### # ##### # # # # # ############# # ##### #
 #       #   #   # # # # #   #         #   #     #
 # ######### # ### ### # ### ##### # # # ### ### #
 # #         #   # #   # # #     # # # # #   #   #
 # ### ### ##### # # ### # ##### ### ### # # #####
 #   # # #     # #   # # #     #   # #   # #     #
 ### # # ##### # ##### # ##### ### # # ######### #
 # # #     #   # #     # #     #   # # #         #
 # # ##### # ### # # ### # ### # ### # # ####### #
   #   #   #   # # #       #   # #   # #   #   # #
## ### ### ### # ############### # ### ### ### # #
 #   #   #   #     #           # #   #   #   #   #
 ### ### ######### # ######### # ### ### ### # ###
   # # #         #   #      A#   #     #   # #   #
 # # # ######### ##### ########### ### ### # ### #
 # # #   #     # #   # #     #   #   #   # #   # #
 # # # # # # ### # # # # ### # # # # ### # ### # #
 # # # # # #   # # #   #   # # #   # #   # #   # #
 # # # # ##### # # ##### # ### ##### ##### # ### #
 #     #       #   #     #         #         #   #
