#####################
#     #             #
# ##### ######### ###
# #     #   #   #   #
# # ##### # # # ### #
# # #   # #   #   # #
# # # # # ####### # #
# # # #     #     # #
# # ### ##### ##### #
# #   # # #   #     #
# ### # # # ### ### #
#  B# # # #   # #   #
# ### # # ### # ### #
#   # #   #   #   # #
# # # ##### # ### # #
# #   #   # # #   # #
# ##### # # # # ### #
#     # # # # # # # #
##### # # # # # # # #
#       #   # #A#   #
#####################
