#####
#  A#
# ###
#  B#
#####
