##########
#         
# ### ### 
#   # # # 
##### # # 
#   # #   
# # # # ##
# #A# #   
# ### ### 
#     #B  
